%%%%%%%%%
%   o   %
%.   o  %
%       %
%   o   %
%G      %
%       %
%    P  %
%%%%%%%%%
