%%%%%%%%%
%   o   %
%.  Po  %
%       %
%   o   %
%G      %
%       %
%       %
%%%%%%%%%
