%%%%%%
%   o%
%G o %
%  . %
%P o %
%%%%%%
