%%%%%%%%%
%       %
%G  ooo %
%   o.o %
%P ooo  %
%%%%%%%%%
